



111111111111
10010000000C
10000111110111
1P0011E000011
1111111111111




