1111111111111111111111111111111111
1P1CCCC1CCCCCCCC11CCCCCCCC1CCCC1C1
1C1111C1CC11111C11C11111CC1C1111C1
1C1CE1C1C111111C11C111111C1C1EC1C1
1C1CC1C1CCCCC00000000CCCCC1C1CC1C1
1CCCCCC11C1C1011001101C1C11CCCCCC1
1C1C11111C1C1010000101C1C11111C1C1
1C1CCCCCCCCC1010000101CCCCCCCCC1C1
1C1C11111111101000010111111111C1C1
1C1CCCCCCCCC1010000101CCCCCCCCC1C1
1C111111111CC01000010CC111111111C1
1CCCCCCCCCCC1011001101CCCCCCCCCCC1
11111C11CCCC1000000001CCCC11C11111
11111C11C1111CC1111CC1111C11C11111
1CCCCC11CCCCCCCC11CCCCCCCC11CCCCC1
1C1111111111111C11C1111111111111C1
1CCCCCCCCCCCCCCC11CCCCCCCCCCCCCCC1
1111111111111111111111111111111111
