1111111111111111111111111111111111
1E000000000000000000000000000000C1
10000000000G00000000G0000000000001
10000000000000G0000000000000000001
1000000000000000000000000G00000001
10000000000000G0000000000000000001
1000000000000000000000000G00000001
10000000000G0000000000000000000001
100000000000000000000G000000000001
10000000000000G0000000000000000001
1000000000000000000000000000000001
1000000000000000G0000G000000000001
1000000000000000000000000000000001
10000000000G0000000000000000000001
1000000000000000000000000000000001
10000000000G0000000000000000000001
1E000000000000000000000000000000P1
1111111111111111111111111111111111
