1111111111111111111111111111111111111111111111111
1GCCCCCCCCCCCCCCCCCCCCCCCCCCCCCCCCCCCCCCCCCCCCCC1
1C111C111111111C111111111111111C111C11111C11111C1
1C111C111111111C111111111111111C111C11111C11111C1
1CCCCC111111111CCCCCCCCCCCCCCCCC111CCCCCCCCCCCCC1
11111C111CCCCCCC1111111C1111111C111C1111111C11111
11111C111C11111C1111111C1111111C111C1111111C11111
11111C111C11111C1100011C1100011C111C110G011C11111
1PCCCC111CCG111C110G011C110G011C111C1111111CCCCE1
11111C111111111C1100011C1100011C111C111CCCCC11111
11111C111111111C1111111C1111111C111C1111111C11111
11111C111111111C1111111C1111111C111C1111111C11111
1CCCCCCCCCCCCCCCCCCCCCCCCCCCCCCCCCCCCCCCCCCCCCCC1
1C1111C1111111111C11C1111111111C111111111C11111C1
1C1111C1111111111C11C1111111111C111111111C11111C1
1CCCCCCCCCCCCCCCCC11CCCCCCCCCCCCCCCCCCCCCCCCCCCC1
1111111111111111111111111111111111111111111111111
