1111111111111111111111111
1G0000000000000000000PCE1
1111111111111111111111111
