
11111
1C001
10P01
100E1
11111
