



1111111111111
10010000000C1
10000111111G1
1P0011E000001
1111111111111




