



1111111111111
1G010000000C1
10G00111110G1
1P0011E000001
1111111111111






