1111111111111
1001000C00001
10000111110G1
1P0011E000001
1111111111111




